NO textures/matrix.xpm
SO textures/matrix.xpm
WE textures/matrix.xpm
EA textures/matrix.xpm

F 0,0,0
C 0,0,0

111111111111111111111
1010N0W0001000000000001
111111111111111111111
