NO textures/matrix.xpm


        WE textures/matrix.xpm

F 0,0,0
C 0,0       ,0

111111111111111111111   1111
1010N0W0001000000000001 1001
111111111111111111111   11111  

EA              textures/matrix.xpm

111111111111111111111   1111
1010N0W0001000000000001 1001
111111111111111111111   11111


S                                  textures/matrix.xpm








