R 800 600

EA          textures/matrix.xpm
SO          textures/matrix.xpm
NO textures/matrix.xpm
WE textures/matrix.xpm

F 0,0,0
C 0,0,0

111111111111111111111111111111
111110W00010000000000011001
100010000000000000000011001
111111111111111111111111111









