R 850 500

F 0,0,0
C 0,0,0

NO ./assets/brick_wall.xpm
WE ./assets/brick_wall.xpm
SO ./assets/brick_wall.xpm
EA ./assets/brick_wall.xpm
S ./assets/gimp_logo.xpm

HK ./assets/healthkit.xpm
PORTAL ./assets/portal.xpm
DOOR ./assets/warn_door.xpm
GOOMBA ./assets/goomba.xpm
SKYBOX ./assets/sky_sun.xpm
FLOOR ./assets/parquet1.xpm
DASH ./assets/dash.xpm
GUN ./assets/shotgun_c.xpm

 111111111111111111111111
1S000000D0000000000000001
1011101110111111011111011
1000101000100010010001001
1000101000100010010001001
1000000000000000000000001
1011111011111011111111011
1000001010001010000010001
1000001010001010000010001
101111111D111011111D11111
1000000000000000000000001
1000001000100010010001001
1011111010111111011111011
100000000000000000000D021
1111111111111111111111111

