NO textures/matrix.xpm
WE textures/matrix.xpm

F 0,0,0
C 0,0,0

    11111111111111111111111111  1111
111110W0001000000010001     1001
1000N0W00000000001 1001     100111
100000W0000000000010001     1001   111
1111111111111111111111      11111

EA          textures/matrix.xpm
SO          textures/matrix.xpm




