                                                              NO  textures/test/north.xpm
WE                      textures/test/west.xpm
EA    textures/test/east.xpm
            SO   textures/test/south.xpm

C   0,0,0

  1 1111111111111111111111111
11111010001000000010001 111                            111111
    1000N0000000000001 100111                       10001
 1000001000000000001000111111                            111111
1111111111111111111111
F   0,0,0
