                      NO  textures/test/north.xpm
WE                      textures/test/west.xpm
EA    textures/test/east.xpm
            SO   textures/test/south.xpm

C   0,0,0

  1 1111111111111111111111  1111
11111010001000000010001111 1111
    1000N000 10011110001   0001
 10000010000000000011111   10001
11111111111111111111111111111111
F   0,0,0
