NO textures/matrix.xpm
WE textures/matrix.xpm
EA          textures/matrix.xpm
SO          textures/matrix.xpm

F 0,0,0
C 0,0,0
R 100 500

111111111111111111111111111111
11111010001000000010001001
1000N0000000000001 1001100111
100000100000000000100011001
111111111111111111111111111

