R 1080 900

NO ./assets/brick_wall.xpm
SO ./assets/terrain.xpm
WE                              ./assets/parquet1.xpm
EA                                                                  ./assets/warn_door_wall.xpm

S                     ./assets/gimp_logo.xpm
F 31,     48,                                   24
C 34,240,164

 111111111111111111111111
1000W00000000000000000001
1000000011111000001000001
1000000001000000010000001
 111111111111111111111111
